##########
##########
##########
----------
##########
-------P--
----------
##########