#-------#-
--------#-
+-------#-
##------#-
##-#--P-#-
------###-
--#-------
--#-------
#-x------#
#######-/#
#-x------#
####--####
#x-------#
##--######
#-----x--#
######--##
#x-------#
####--####
#--------#
##--######
#------*-#
##########