----------
----------
----------
----------
----------
----------
----------
*--P------
##########